1111111
1PCE1C1
1CCCCC1
1111111