1111111111111111111
1000101000101000011
1000100001EC1000111
10001001001P0000011
1100001000001000011
1000000100000101011
1000000000000000101
1000000000000000101
1111111111111111111