111111111111111111
1E0S00001CC0000001
10SPS0CC1000000001
100000CC0000000001
100000CC0000000001
100000CC0000000001
100000CC0000000001
100000CC0000000001
100000CC0000000001
100000CC0000000001
111111111111111111